01 01 01 01 01 01 01 01 01 01 01 01 01 01 01 01 01 01 01 01 
01 00 00 00 01 00 00 00 00 00 e2 00 e2 00 e2 00 e2 00 00 01 
01 00 00 00 01 00 00 00 00 00 00 00 00 00 00 00 00 00 00 01 
01 00 00 00 01 00 00 00 00 00 00 00 00 00 00 00 00 00 00 01 
01 01 02 02 01 03 03 03 03 03 03 03 01 03 03 03 03 03 03 01 
01 00 00 00 00 00 00 00 00 00 00 00 03 00 00 00 00 00 nl 01 
01 00 00 00 00 00 00 00 03 00 00 00 00 00 00 03 00 00 00 01 
01 01 01 01 01 03 03 03 01 03 03 03 03 03 03 01 03 03 03 01 
01 00 00 00 01 00 00 00 00 00 00 00 00 00 00 00 00 00 00 01 
01 00 00 00 01 00 00 00 00 00 00 00 00 00 00 00 00 00 00 01 
01 00 00 00 01 00 00 00 e2 00 e2 00 e2 00 e2 00 e2 00 00 01 
01 01 01 01 01 01 01 01 01 01 01 01 01 01 01 01 01 01 01 01 
