01 01 01 01 01 01 01 01 01 01 01 01 01 01 01 01 01 01 01 01 
01 00 00 00 00 00 02 00 00 00 00 00 00 00 00 00 00 00 00 01 
01 00 00 00 00 00 02 00 00 00 00 00 00 00 00 00 00 00 00 01 
01 00 00 00 00 00 02 00 00 00 00 00 00 00 00 00 00 nl 00 01 
01 00 00 00 00 00 02 00 e2 00 00 00 00 00 00 00 00 00 00 01 
01 01 01 01 01 01 01 01 01 01 01 01 01 01 01 01 01 01 01 01 
01 00 00 00 00 00 00 00 00 00 00 00 00 00 00 00 00 00 00 01 
01 00 00 00 00 00 00 00 00 00 00 00 00 00 00 00 00 00 00 01 
01 00 00 00 00 00 00 00 00 00 00 00 00 00 00 00 00 00 00 01 
01 00 00 00 00 00 00 00 00 e2 e2 00 00 00 00 00 00 00 00 01 
01 su su su su su su su su su su su su su su su su su su 01 
01 01 01 01 01 01 01 01 01 01 01 01 01 01 01 01 01 01 01 01 
