01 01 01 01 01 01 01 01 01 01 01 01 
01 00 00 00 00 00 00 00 00 00 00 01 
01 00 00 00 00 00 00 00 00 00 00 01 
01 00 00 00 00 01 01 00 00 00 00 01 
01 00 00 00 00 00 00 00 00 00 00 01 
01 e1 00 00 00 00 00 00 00 00 00 01 
01 01 01 01 01 01 00 00 00 00 00 01 
01 00 00 00 00 00 00 00 00 00 00 01 
01 00 e1 00 00 00 00 00 00 00 00 01 
01 01 01 00 00 00 00 00 00 00 00 01 
01 00 00 00 00 00 00 00 00 00 00 01 
01 00 00 00 00 00 00 00 00 00 00 01 
01 00 00 00 00 00 00 00 00 00 00 01 
01 00 00 00 01 01 01 01 01 01 01 01 
01 00 00 00 00 00 00 00 00 00 e1 01 
01 00 00 00 00 00 00 00 00 01 01 01 
01 00 00 00 00 00 00 00 00 00 00 01 
01 00 00 00 00 00 00 00 00 00 00 01 
01 e1 00 00 00 00 00 00 00 00 00 01 
01 01 01 01 01 01 01 01 01 00 00 01 
01 00 00 00 00 00 00 00 00 00 00 01 
01 00 00 00 00 00 00 00 00 00 00 01 
01 00 00 00 00 00 00 00 00 00 00 01 
01 00 00 00 00 00 00 00 00 00 00 01 
01 00 00 00 00 00 00 00 00 00 00 01 
01 00 00 00 00 00 00 00 00 00 e1 01 
01 00 00 01 01 01 01 01 01 01 01 01 
01 00 00 00 00 00 00 00 00 00 00 01 
01 00 00 00 00 00 00 00 00 00 00 01 
01 00 00 00 00 00 00 00 00 00 00 01 
01 00 00 00 00 00 00 00 00 00 00 01 
01 00 00 00 00 00 00 00 00 00 00 01 
01 00 00 00 00 00 00 00 00 00 00 01 
01 00 00 00 00 00 00 00 00 00 00 01 
01 01 01 01 01 01 01 00 00 00 00 01 
01 00 00 00 00 00 00 00 00 00 00 01 
01 00 00 00 00 00 00 00 00 00 00 01 
01 00 00 00 00 00 00 00 00 nl 00 01 
01 e1 e1 e1 00 e1 00 00 00 00 00 01 
01 01 01 01 01 01 01 01 01 01 01 01 