01 01 01 01 01 01 01 01 01 01 01 01 01 01 01 01 01 01 01 01 
01 00 00 00 00 00 00 01 00 00 00 00 00 00 00 00 00 00 00 01 
01 00 00 00 00 00 00 01 00 00 00 00 00 00 00 00 00 00 00 01 
01 00 00 00 00 00 00 01 00 00 00 00 00 00 00 00 00 nl 00 01 
01 00 00 00 00 00 00 01 00 00 00 00 00 00 00 00 00 00 00 01 
01 01 01 01 00 00 00 01 01 01 01 02 02 01 01 01 01 01 01 01 
01 00 00 00 00 00 00 02 00 00 00 00 00 00 00 00 00 00 00 01 
01 00 00 00 00 00 00 02 00 00 00 00 01 00 00 00 00 00 00 01 
01 00 00 00 00 00 00 02 00 00 00 00 00 00 00 00 00 00 00 01 
01 00 00 00 00 00 00 02 01 01 01 01 00 00 00 00 00 00 00 01 
01 00 00 00 00 g2 00 su su su su su su su su su su su su 01 
01 01 01 01 01 01 01 01 01 01 01 01 01 01 01 01 01 01 01 01 
