01 01 01 01 01 01 01 01 01 01 01 01 01 01 01 01 01 01 01 01 
01 00 00 01 00 00 01 00 00 01 00 00 01 00 00 01 00 00 00 01 
01 00 00 01 00 00 01 01 01 01 00 00 01 00 00 01 00 00 00 01 
01 00 00 01 01 02 02 00 00 02 00 00 01 00 00 02 00 nl 00 01 
01 01 00 01 00 00 02 00 00 02 01 02 01 01 02 02 01 01 01 01 
01 00 00 01 00 00 01 01 01 01 00 00 02 00 00 02 00 00 00 01 
01 00 00 01 01 02 02 00 00 01 00 00 02 00 00 01 00 00 00 01 
01 01 00 02 00 00 02 00 00 01 01 01 01 00 00 01 01 01 01 01 
01 00 00 02 00 00 01 01 01 01 00 00 01 01 01 01 00 00 00 01 
01 00 00 01 01 01 01 00 00 01 00 00 01 00 00 01 00 00 00 01 
01 su su 01 su su 01 su su 01 su su 01 su su 01 su su su 01 
01 01 01 01 01 01 01 01 01 01 01 01 01 01 01 01 01 01 01 01 
