w6 w6 w6 w6 w6 w6 w6 w6 w6 w6 w6 w6 w6 w6 w6 w6 w6 w6 w6 w6 w6 w6 w6 w6 w6 w6 w6 w6 w6 w6 w6 w6 w6 w6 w6 w6 w6 w6 w6 w6 w6 
w6 g3 g3 g4 g3 g2 g3 g3 g2 g3 g2 g2 g3 g3 g3 g4 g2 g2 g2 g2 g2 g3 g3 g2 g2 g3 g2 g2 g3 g2 g3 g4 g2 g2 g1 g4 g1 g2 g2 g3 w6 
w6 g3 g4 g3 g2 g3 g3 g2 g3 g2 g2 g3 g3 g3 g4 g2 g2 g2 g2 g2 g3 g3 g2 g2 g3 g2 g2 g3 g2 g3 g4 g2 g2 g1 g4 g1 g2 g2 g3 g2 w6 
w6 g4 g3 g2 g3 g3 g2 g3 g2 g2 g3 g3 g3 g4 g2 g2 g2 g2 g2 g3 g3 g2 g2 g3 g2 g2 g3 g2 g3 g4 g2 g2 g1 g4 g1 g2 g2 g3 g2 g2 w6 
w6 g3 g2 g3 g3 g2 g3 g2 g2 g3 g3 g3 g4 g2 g2 g2 g2 g2 g3 g3 g2 g2 g3 g2 g2 g3 g2 g3 g4 g2 g2 g1 g4 g1 g2 g2 g3 g2 g2 g3 w6 
w6 g2 g3 g3 g2 g3 g2 g2 g3 g3 g3 g4 g2 g2 g2 g2 g2 g3 g3 g2 g2 g3 g2 g2 g3 g2 g3 g4 g2 g2 g1 g4 g1 g2 g2 g3 g2 g2 g3 g2 w6 
w6 g3 g3 g2 g3 g2 g2 g3 g3 g3 g4 g2 g2 g2 g2 g2 g3 g3 g2 g2 g3 g2 g2 g3 g2 g3 g4 g2 g2 g1 g4 g1 g2 g2 g3 g2 g2 g3 g2 g2 w6 
w6 g3 g2 g3 g2 g2 g3 g3 g3 g4 g2 g2 g2 g2 g2 g3 g3 g2 g2 g3 g2 g2 g3 g2 g3 g4 g2 g2 g1 g4 g1 g2 g2 g3 g2 g2 g3 g2 g2 g3 w6 
w6 g2 g3 g2 g2 g3 g3 g3 g4 g2 g2 g2 g2 g2 g3 g3 g2 g2 g3 g2 g2 g3 g2 g3 g4 g2 g2 g1 g4 g1 g2 g2 g3 g2 g2 g3 g2 g2 g3 g1 w6 
w6 g3 g2 g2 g3 g3 g3 g4 g2 g2 g2 g2 g2 g3 g3 g2 g2 g3 g2 g2 g3 g2 g3 g4 g2 g2 g1 g4 g1 g2 g2 g3 g2 g2 g3 g2 g2 g3 g1 g2 w6 
w6 g2 g2 g3 g3 g3 g4 g2 g2 g2 g2 g2 g3 g3 g2 g2 g3 g2 g2 g3 g2 g3 g4 g2 g2 g1 g4 g1 g2 g2 g3 g2 g2 g3 g2 g2 g3 g1 g2 g2 w6 
w6 g2 g3 g3 g3 g4 g2 g2 g2 g2 g2 g3 g3 g2 g2 g3 g2 g2 g3 g2 g3 g4 g2 g2 g1 g4 g1 g2 g2 g3 g2 g2 g3 g2 g2 g3 g1 g2 g2 g3 w6 
w6 g3 g3 g3 g4 g2 g2 g2 g2 g2 g3 g3 g2 g2 g3 g2 g2 g3 g2 g3 g4 g2 g2 g1 g4 g1 g2 g2 g3 g2 g2 g3 g2 g2 g3 g1 g2 g2 g3 g3 w6 
w6 g3 g3 g4 g2 g2 g2 g2 g2 g3 g3 g2 g2 g3 g2 g2 g3 g2 g3 g4 g2 g2 g1 g4 g1 g2 g2 g3 g2 g2 g3 g2 g2 g3 g1 g2 g2 g3 g3 g2 w6 
w6 g3 g4 g2 g2 g2 g2 g2 g3 g3 g2 g2 g3 g2 g2 g3 g2 g3 g4 g2 g2 g1 g4 g1 g2 g2 g3 g2 g2 g3 g2 g2 g3 g1 g2 g2 g3 g3 g2 g1 w6 
w6 g4 g2 g2 g2 g2 g2 g3 g3 g2 g2 g3 g2 g2 g3 g2 g3 g4 g2 g2 g1 g4 g1 g2 g2 g3 g2 g2 g3 g2 g2 g3 g1 g2 g2 g3 g3 g2 g1 g1 w6 
w6 g2 g2 g2 g2 g2 g3 g3 g2 g2 g3 g2 g2 g3 g2 g3 g4 g2 g2 g1 g4 g1 g2 g2 g3 g2 g2 g3 g2 g2 g3 g1 g2 g2 g3 g3 g2 g1 g1 g3 w6 
w6 g2 g2 g2 g2 g3 g3 g2 g2 g3 g2 g2 g3 g2 g3 g4 g2 g2 g1 g4 g1 g2 g2 g3 g2 g2 g3 g2 g2 g3 g1 g2 g2 g3 g3 g2 g1 g1 g3 g2 w6 
w6 g2 g2 g2 g3 g3 g2 g2 g3 g2 g2 g3 g2 g3 g4 g2 g2 g1 g4 g1 g2 g2 g3 g2 g2 g3 g2 g2 g3 g1 g2 g2 g3 g3 g2 g1 g1 g3 g2 g2 w6 
w6 g2 g2 g3 g3 g2 g2 g3 g2 g2 g3 g2 g3 g4 g2 g2 g1 g4 g1 g2 g2 g3 g2 g2 g3 g2 g2 g3 g1 g2 g2 g3 g3 g2 g1 g1 g3 g2 g2 g2 w6 
w6 g2 g3 g3 g2 g2 g3 g2 g2 g3 g2 g3 g4 g2 g2 g1 g4 g1 g2 g2 g3 g2 g2 g3 g2 g2 g3 g1 g2 g2 g3 g3 g2 g1 g1 g3 g2 g2 g2 g2 w6 
w6 g3 g3 g2 g2 g3 g2 g2 g3 g2 g3 g4 g2 g2 g1 g4 g1 g2 g2 g3 g2 g2 g3 g2 g2 g3 g1 g2 g2 g3 g3 g2 g1 g1 g3 g2 g2 g2 g2 g2 w6 
w6 g3 g2 g2 g3 g2 g2 g3 g2 g3 g4 g2 g2 g1 g4 g1 g2 g2 g3 g2 g2 g3 g2 g2 g3 g1 g2 g2 g3 g3 g2 g1 g1 g3 g2 g2 g2 g2 g2 g2 w6 
w6 g2 g2 g3 g2 g2 g3 g2 g3 g4 g2 g2 g1 g4 g1 g2 g2 g3 g2 g2 g3 g2 g2 g3 g1 g2 g2 g3 g3 g2 g1 g1 g3 g2 g2 g2 g2 g2 g2 g4 w6 
w6 g2 g3 g2 g2 g3 g2 g3 g4 g2 g2 g1 g4 g1 g2 g2 g3 g2 g2 g3 g2 g2 g3 g1 g2 g2 g3 g3 g2 g1 g1 g3 g2 g2 g2 g2 g2 g2 g4 g2 w6 
w6 g3 g2 g2 g3 g2 g3 g4 g2 g2 g1 g4 g1 g2 g2 g3 g2 g2 g3 g2 g2 g3 g1 g2 g2 g3 g3 g2 g1 g1 g3 g2 g2 g2 g2 g2 g2 g4 g2 g4 w6 
w6 g2 g2 g3 g2 g3 g4 g2 g2 g1 g4 g1 g2 g2 g3 g2 g2 g3 g2 g2 g3 g1 g2 g2 g3 g3 g2 g1 g1 g3 g2 g2 g2 g2 g2 g2 g4 g2 g4 g1 w6 
w6 g2 g3 g2 g3 g4 g2 g2 g1 g4 g1 g2 g2 g3 g2 g2 g3 g2 g2 g3 g1 g2 g2 g3 g3 g2 g1 g1 g3 g2 g2 g2 g2 g2 g2 g4 g2 g4 g1 g2 w6 
w6 g3 g2 g3 g4 g2 g2 g1 g4 g1 g2 g2 g3 g2 g2 g3 g2 g2 g3 g1 g2 g2 g3 g3 g2 g1 g1 g3 g2 g2 g2 g2 g2 g2 g4 g2 g4 g1 g2 g2 w6 
w6 g2 g3 g4 g2 g2 g1 g4 g1 g2 g2 g3 g2 g2 g3 g2 g2 g3 g1 g2 g2 g3 g3 g2 g1 g1 g3 g2 g2 g2 g2 g2 g2 g4 g2 g4 g1 g2 g2 g3 w6 
w6 g3 g4 g2 g2 g1 g4 g1 g2 g2 g3 g2 g2 g3 g2 g2 g3 g1 g2 g2 g3 g3 g2 g1 g1 g3 g2 g2 g2 g2 g2 g2 g4 g2 g4 g1 g2 g2 g3 g3 w6 
w6 g4 g2 g2 g1 g4 g1 g2 g2 g3 g2 g2 g3 g2 g2 g3 g1 g2 g2 g3 g3 g2 g1 g1 g3 g2 g2 g2 g2 g2 g2 g4 g2 g4 g1 g2 g2 g3 g3 g1 w6 
w6 g2 g2 g1 g4 g1 g2 g2 g3 g2 g2 g3 g2 g2 g3 g1 g2 g2 g3 g3 g2 g1 g1 g3 g2 g2 g2 g2 g2 g2 g4 g2 g4 g1 g2 g2 g3 g3 g1 g3 w6 
w6 g2 g1 g4 g1 g2 g2 g3 g2 g2 g3 g2 g2 g3 g1 g2 g2 g3 g3 g2 g1 g1 g3 g2 g2 g2 g2 g2 g2 g4 g2 g4 g1 g2 g2 g3 g3 g1 g3 g4 w6 
w6 g1 g4 g1 g2 g2 g3 g2 g2 g3 g2 g2 g3 g1 g2 g2 g3 g3 g2 g1 g1 g3 g2 g2 g2 g2 g2 g2 g4 g2 g4 g1 g2 g2 g3 g3 g1 g3 g4 g2 w6 
w6 g4 g1 g2 g2 g3 g2 g2 g3 g2 g2 g3 g1 g2 g2 g3 g3 g2 g1 g1 g3 g2 g2 g2 g2 g2 g2 g4 g2 g4 g1 g2 g2 g3 g3 g1 g3 g4 g2 g1 w6 
w6 g1 g2 g2 g3 g2 g2 g3 g2 g2 g3 g1 g2 g2 g3 g3 g2 g1 g1 g3 g2 g2 g2 g2 g2 g2 g4 g2 g4 g1 g2 g2 g3 g3 g1 g3 g4 g2 g1 g2 w6 
w6 g2 g2 g3 g2 g2 g3 g2 g2 g3 g1 g2 g2 g3 g3 g2 g1 g1 g3 g2 g2 g2 g2 g2 g2 g4 g2 g4 g1 g2 g2 g3 g3 g1 g3 g4 g2 g1 g2 g2 w6 
w6 g2 g3 g2 g2 g3 g2 g2 g3 g1 g2 g2 g3 g3 g2 g1 g1 g3 g2 g2 g2 g2 g2 g2 g4 g2 g4 g1 g2 g2 g3 g3 g1 g3 g4 g2 g1 g2 g2 g3 w6 
w6 g3 g2 g2 g3 g2 g2 g3 g1 g2 g2 g3 g3 g2 g1 g1 g3 g2 g2 g2 g2 g2 g2 g4 g2 g4 g1 g2 g2 g3 g3 g1 g3 g4 g2 g1 g2 g2 g3 g2 w6 
w6 w6 w6 w6 w6 w6 w6 w6 w6 w6 w6 w6 w6 w6 w6 w6 w6 w6 w6 w6 w6 w6 w6 w6 w6 w6 w6 w6 w6 w6 w6 w6 w6 w6 w6 w6 w6 w6 w6 w6 w6 
